Simmons	William
Jeyabalan	Geetha
Yu	Yanping
Muthuswamy	Ravikumar
Wendell	Steven
Field	Jessica
OKeefe	Stephen
Martin-Gill	Christian
Simhan	Hyagriv
Xiao	Gutian
Lin	Albert
Pingpank	James
Holguin	Fernando
Davit	Alexander
Cleves Bayon	Catalina
Casselbrant	Margaretha
Quinlan	Joseph
Sluis-Cremer	Nicolas
Chopra	Kapil
Regueiro	Miguel
Stone	David
McDade	Eric
Kato	Gregory
Hausmann	Leslie
Ganott	Marie
Ford	Natalia
Whitley	Kevin
Mcgrath	Kevin
Buffington	Charles
Hoffman	Robert
Weiner	Daniel
Clark	Beth
Clark	Nathaniel
Ryan	John
Sinha	Amit
Balest	Arcangela
Hughey	Rebecca
Davis	Derek
Kline	Christopher
Doperak	Jeanne
Subramanya	Arohan
Krajewski	Colleen
Horn	John
Arnold	Georgianne
Michaels	Richard
Kirkwood	John
Anderson	Carol
Khoo	Nicholas
Enwright	John
Poe	Michele
El-Gharbawy	Areeg
Richardson	Ward
Chennat	Jennifer
Berndt	Annerose
Tobias	Adam
McCall	Andrew
Boutaoui	Nadia
Smithgall	Thomas
Mctiernan	Charles
Fan	Jie
Gold	Michael
Gannon	Jessica
Seymour	Christopher
Surti	Urvashi
Bielefeldt	Klaus
Zhao	Chengquan
Miller	Susan
Zyczynski	Halina
Sholosh	Biatta
Cordle	Andrew
Morgan	Judith
Corbelli	Jennifer
Witchel	Selma
Kim	Seonggi
Jain	Samay
Muto	Carlene
Winnica	Daniel
Keljo	David
Dixon	Clifton
Ontell	Marcia
Pedersen	Sarah
Lin	Bo
Kasckow	John
Losee	Joseph
Caritis	Stanley
Stremple	John
Rao	Uma
Tauxe	W.Newlon
Ayoob	Joseph
Fournier	Jay
Zhou	Hui
Vergidis	Paschalis
Rodosky	Mark
Golla	Suman
Chang	Chung-Chou
Soman	Prem
Singh	Michael
Horton	Leslie
Depietro	Frank
Smith	Matthew
Aneja	Rajesh
Dobrowolski	Steven
Sandy	Edward
McGuire	Kandace
Stephany	Heidi
Chen	Xiaohua
Loeber	Rolf
Muldoon	Matthew
Maurer	Scott
Versace	Amelia
Altschuler	Daniel
Pu	Jiantao
Choudry	Mohammad
Johnson	Jennifer
Ghinassi	Frank
Mitchell	Galen
Krohn	Marijane
Orons	Philip
Anixter	Martin
Thakkar	Kavita
Bhargava	Rohit
Pu	Hongjian
Mcgonigle	John
Rindos	Noah
Mcgough	Richard
Ahrendt	Steven
Lokshin	Anna
Zarnegar	Abdolreza
Gaines	Barbara
Bartels	Amelia
Friedman	Peter
Taylor	Paul
D'Amico	Adrian
Mosesso	Vincent
Al Hashash	Jana
Apetrei	Cristian
Yankura	David
Fabrega	Horacio
Ogren	Eric
Fukuda	Mitsuhiro
Edwards	Robert
Morton	Sara
Lieberman	Frank
Leme	Adriana
Hilmi	Ibtesam
Sumkin	Jules
Krans	Elizabeth
Davidson	Nancy
Courtney-Brooks	Madeleine
Ivanov	Emil
Trucco	Sara
Williams	Brian
Obedian	Michael
Pierri	Joseph
Ambrose	Zandrea
Ziembicki	Jenny
Huang	Marilyn
Hurh	Peter
Jedema	Hank
Kreutzer	Jacqueline
Gorske	Tad
Maier	John
Schmelzer	Eva
Ofori-Acquah	Solomon
Tian	Jianmin
Pardini	Dustin
Paradise	Jack
Thiels	Edda
Graves	James
Mellors	John
Kiss	Joseph
George	Marjorie
Reilly	John
Ishizawar	David
Lynch	Michael
Mitchell	Ellen
Gozansky	Elliott
Klimstra	William
Vlad	Anda
Morganroth	Sally
Smitherman	Thomas
Seethala	Raja
Wizorek	Joseph
Huang	Xin
Benson	Maggie
Borghesi	Lisa
Monk	Timothy
Eller	Andrew
Rabin	Bruce
Chu	Alan
Murugan	Raghavan
Taylor	Aisha
Reitschuler Cross	Eva
Norris	Karen
Russo	Linda
Berman	Sarah
Minervini	Marta
Zou	Chunbin
Molyneaux	Bradley
Krivinko	Dennis
Elmer	Jonathan
Velayutham	Murugesan
Dew	Mary
Gurtunca	Nursen
Shin	Donghun
Awais	Omar
Nemec	Jan
Tyagi	Pradeep
Wang	Eric
Husain	Sohail
Picarsic	Jennifer
Peters	Jeffrey
Haupt	Alicia
Watson	Andrew
Chang	Judy
Dhupar	Rajeev
Li	Zhigang
Shah	Rajiv
Sparks	Garrett
Bunimovich	Olga
Devlin	Bernard
Snyderman	Carl
Mansuria	Suketu
Hrebinko	Ronald
Loewen	Nils
Lin	Philana
Cruz	Ruy
Akhtar	Jawaid
Thorkelson	Gregory
Nasonkin	Igor
Lopez	Alejandro
Seney	Marianne
Lu	Binfeng
Jones	Neil
Kim	Seung
Helfield	Brandon
Obrist	Walter
Marra	Kacey
Meisler	Arnold
Mehlman	Tracey
Handler	Steven
Driscoll	Henry
Shutter	Lori
Ryan	Christopher
Zhang	Ke
McCoy	Kelly
Fox	Andrea
Urbach	Andrew
Costello	Joanna
Agha	Mounzer
Smetana	Roy
Herlich	Andrew
Finn	Olivera
Wildes	Jennifer
Obagi	Suzan
Peters	David
Zhang	Xichen
Devor	Daniel
Shair	Kathy Ho Yen
Chu	Charleen
Rosengart	Matthew
Tarchichi	Tony
Feng	Bin
Wolfson	Sidney
Taylor	Jennifer
Grenvik	Ake
Trucco	Giuliana
Emlet	Lillian
Spahr	Jonathan
Nimick	Theresa
Rogal	Shari
Marill	Keith
Mallampalli	Rama
Szigethy	Eva
Nischal	Kanwal
Han	Yueh-Ying
Ho	Jacqueline
Williams	Shelley
Yabes	Jonathan
Windreich	Randy
West	Shawn
Barak	Yaacov
Larkin	Jacob
Chen	Beibei
Lewis	David
Kane	Lawrence
Cohen	Richard
Salvin	Samuel
Zenati	Mazen
Casement	Melynda
Wilmot	Andrew
Kass	Daniel
Bender	Filitsa
Luke	Clifford
Dacic	Sanja
Pilewski	Joseph
Liman	Agnes
Camhi	Sharon
Szabolcs	Paul
Kofler	Julia
Musahl	Volker
Zhang	Li-Ming
Clark	Duncan
Pardini	Jamie
Moore	Jason
Reddy	Cara
Hamilton	David
Weisz	Ora
Green	Todd
Wolfson	Allan
Patel	Sureshchandra
Schmithorst	Vincent
Alcaina	Yago
Pakraftar	Sam
Agarwal	Vikas
Klunk	William
Fink	Ericka
Wijkstrom	Martin
Smith	Libby
Fine	Jeffrey
Phillippi	Julie
Schwarz	Samuel
Edinger	Jason
Chen	Wei
Hu	Xiaoming
Levine	Michele
Wilson	Mark
Phillips	Stephen
Kwak	Eun
Lotze	Michael
Marsh	Jane
Rastogi	Priya
Vockley	Gerard
Dewar	Stephanie
Horn	Charles
Jackson	Edwin
Habeych Sanmiguel	Miguel
Larregina De Morelli	Adriana
Mccausland	Julie
Ishima	Rieko
Lee	Kenneth
Mcintire	Sara
Hendrickson	Ricky
Whiting	Bruce
Fakhran	Saeed
Kolthoff	Marta
Kahn	Charles
Strick	Peter
Watchko	Jon
Shurin	Michael
Kathjv	Sandeep
Lee	Stella
Burton	Edward
Lanphere	Julie
Qin	Shulin
Doshi	Ankur
Oravitz	Todd
Lin	Chyongchiou
McCauley	Heather
Garibaldi	Luigi
Fuschiotti	Patrizia
Lunsford	L
DeGenna	Natacha
Fish	Larry
Morato	Daniela
Cohen	Justus
Gathuru	Irene
Yuo	Theodore
Liu	Hongjun
Ladouceur	Cecile
Kaldas	Hoda
Moss	Deborah
Moran	Colleen
Stefko	Susan
Lopresti	Brian
Meng	Li
Painter	Thomas
Nikiforov	Yuri
Dhir	Rajiv
Wu	Jian
Liu	XiaoQin
Day	Nancy
Slivka	Adam
Webster	Marshall
Parniak	Michael
Mountz	James
Huard	Johnny
Ramani	Ravi
Jhamb	Manisha
Apodaca	Gerard
Schmitz	John
Van Laar	Amber
Zhao	Yutong
Brent	David
Kinchington	Paul
Broyles	Lauren
Steketee	Michael
Van Londen	Gijsberta
South-Paul	Jeannette
Mandel	Ellen
Spagnoletti	Carla
Sam	Hakeem
Sadovsky	Yoel
Delgoffe	Greg
Hanmer	Janel
Hall	Martha
Gambotto	Andrea
Parikh	Rahul
Gleason	Thomas
Hu	Jing
Roman	Anna
Green	Michael
Dewar	James
Palladino	Michael
Daley	Dennis
Singhi	Aatur
Halfter	Willi
Zhao	Jinming
Jacob	Tija
Hannibal	Kristin
Rothstein	David
Hooks	Bryan
Murray	Peter
Furey	William
Srinivasan	Abhayasmha
Mahoney	John
Streitman	David
Greer	Julia
Abdel-Hamid	Hoda
Kapoor	Wishwa
Murray	Andrew
Brode	Susan
Zuley	Margarita
Moreland	Larry
Olawaiye	Alexander
Jacobs	Bruce
Lieberman	Irving
Garcia	Angela
Solari	Mario
Shinde	Dilip
Cain	James
Tarhini	Ahmad
Claxton	Rene
Bigley	Joel
Knepper	Laurie
Sonis	Meyer
Ramesh	Makum
Marone	Luke
Guo	Zong
Potoka	Karin
Meyer	Viveca
Baker	Evan
LaFramboise	William
Chen	Mang
Gedela	Satyanarayana
Hall	Daniel
Singh	Jagjit
Fowler	John
Sun	Dandan
Nishikawa	Robert
Corb	Michael
Zuckerbraun	Noel
Tamama	Kenichi
Gill	Thomas
Counihan	Mary
Lee	Joon
Park	Na Jin
Byersdorfer	Craig
Donahoe	Michael
Mettenburg	Joseph
Perera	KPG
Posluszny	Donna
Zaydan	Islam
Faber	Christopher
Zuckerman	Daniel
Vitturi Iglesias	Dario
Vitale	Melissa
Socinski	Mark
Zimmer	Shanta
Pollock	Gary
Hwang	Yong
Nebes	Robert
Finestone	Stephen
Johnson	Bruce
Randhawa	Parmjeet
Funderburgh	James
Chakravorty	Sangeeta
Fireman	Philip
Bauer	Philip
Bylsma	Lauren
Boyce	Richard
Krushansky	Evonne
Sumrok	Vanessa
Shope	Timothy
Forman	Daniel
Santos Martin	Ernesto
Swarts	John
Lagemann	Gerritt
Guse	Sabrina
Beriwal	Sushil
Aggarwal	Shushma
Rossi	Michelle
Chen	Alex
James	Alaina
Waltner-Toews	Rebecca
Wang	Qiming
Donovan	John
Short	Robert
Guo	Zhong
Forno	Erick
Kar	Erica
Anderson	Kelley
Roth	Loren
Homa	Fred
Button	Sean
Fasanella	Kenneth
Kim	Hyun
Zhang	Feng
Gough	Albert
Lacomis	David
Levin	William
Herrle	Scott
Goncharova	Elena
French	Jonathan
Doberer	Daniel
Jennings	J
Sood	Puneet
Esper	Stephen
Coates	Matthew
Muzumdar	Hiren
Shapiro	Steven
Arenth	Patricia
Heller	Matthew
Gingrich	Jeffrey
Hoberman	Alejandro
Nguyen	Minh
Canavan	Timothy
Denko	Timothey
Drexler	Scott
Deutsch	Melvin
Lu	Amy
Venditti	Elizabeth
Huang	David
Binder	Robert
Ghearing	Gena
Wang	Jieru
Harrington	Amanda
Hugo	Julie
Szanto	Katalin
Azzam	Pierre
Bastacky	Sheldon
Gorelik	Elieser
Connamacher	Robert
Bulova	Peter
Shellmer	Diana
Puwanant	Araya
Rosenstock	Jason
Hassan	Shuja
BonHomme	Gabrielle
Stabile	Laura
Ezaru	Catalin
Gedekoh	Robert
Boujoukos	Arthur
Van der Wel	Patrick
Macpherson	David
Cai	Wei
Morycz	Richard
Hoffman	Rosemary
Kurland	Geoffrey
Rao	R
Vogt	Andreas
Xia	Yaqin
OSullivan	Roderick
Arnold	Robert
Redner	Robert
Tang	Dao Lin
Musher	Jeremy
Parviainen-Yang	Eeva Liisa Kristiina
Robertson	Linda Barry
Yazer	Mark
Wagner	Amy
Lincoln	Danforth
Wen	Xiaoyan
Myerburg	Michael
Rivera Lebron	Belinda
Sadecky	Amanda
Siegle	Greg
Swerdlow	Steven
Hahm	Eun-Ryeong
Wei	Xiangyun
Freeman	Bruce
Scott	Iain
Helm	Eric
Quintana Perez	Ariana
Pan	Lisa
Boltz	Robert
Tilstra	Sarah
Zigmond	Michael
Farah	Rafic
Schuchert	Matthew
Swiatecka-Urban	Agnieszka
Sanders	Timothy
Yan	Zhengzheng
Xiao	Xiangwei
Berg	Jeremy
Jin	Honghua
Phillips	Mary
Emert-Sedlak	Lori
Plant	Tony
Planinsic	Raymond
Qu	Lirong
Simmons	Richard
Stolz	Donna
Park	Sang
Sindhi	Rakesh
Marsh	James
Barrie	Arthur
Comerci	John
Odell	David
Lubetsky	Martin
Harvey	Joan
Murray	Sandra
Kietz	Daniel
Mctigue	Kathleen
Salama	Guy
Kale	Hrishikesh
Criscimanna	Angela
La	Junho
Beerman	Lee
Sahu	Abhiram
Wolford	Jennifer
Scandrett	Karen
Dietz	Laura
Bermudez	Christian
Rath	Tanya
Okonkwo	David
Hastings	Teresa
Edelstone	Daniel
Amenta	Joseph
Cohen	Debra
Leuba	Sanford
Veraldi	Kristen
Kavalieratos	Dionysios
Seaman	Craig
Bauza	Graciela
Hubel	Carl
Woodyear	Dawna
Chibisov	Irina
Aggarwal	Nidhi
Albers	Kathryn
Zabbarova	Irina
Hogan	MaCalus
Villaruz	Liza
Summers	Jessica
Sagan	Elizabeth
Chermansky	Christopher
Schurdak	Mark
Hipwell	Alison
Korytkowski	Mary
Carter	Gloria
Mishra	Sanjay
Squires	Robert
Sisk	Thomas
Muigai	David
Chappell	Catherine
Schmidt	John
Celebrezze	James
Kettel	Jessica
Bauer	Eileen
Alhilali	Lea
Shiva	Sruti
Tuchman	Jay
Owusu-Ansah	Amma
Rosen	Johanna
Day	Hollis
Sundar Raj	Nirmala
Kaji	Kaori
Brand	Randall
Espandar	Ladan
Majima	Tsuyashi
Bochkoris	Matthew
Butters	Meryl
Painter	Michael
Friedlander	Robert
Wei	Lawrence
Basse	Per
Baldisseri	Marie
Rosen	Clark
Duquesnoy	Rene
McClung	Colleen
Streib	Christopher
Yang	Muqing
Buchert	Andrew
Hughes	Nolan
Phrampus	Erin
Dasyam	Anil
Guyette	Maria
Wills	Zachary
Hu	Dong
Gierl	Brian
Kaye	Walter
Stronach	Beth
Ray	Anuradha
Tao	Cheng
Kim	Jiyun
Ozolek	John
Flynn	Joanne
Kloesz	Jennifer
Abebe	Kaleab
Gardner	Paul
Lezon	Timothy
Tumuluru	Rameshwari
Au	Alicia
Macatangay	Bernard Jonas
Himes	Katherine
Kaufmann	Robert
Jacobson	Rebecca
Mcgee	James
Whitaker Reynolds	Erin
Maguire	Raymond
Martel	Joseph
Jacob	Rolf
Gronenborn	Angela
Siska	Peter
Tarin	Tatum
Ferguson	Berrylin
Carlisle	Diane
Martich	George
Bomberger	Jennifer
Trivedi	Sumita
Wolfson	Lee
Yang	Haitao
Beigi	Richard
Michaels	Marian
Mattila	Joshua
Donnenberg	Albert
Steele	Mark
Teuteberg	Winifred
Lindhiem	Oliver
Beaman	Shawn
Goetzman	Eric
Veldkamp	Peter
Jankowitz	Brian
Anderson	Carolyn
Angus	Derek
Olafiranye	Oladipupo
Matthews	Karen
Ferson	Peter
Lu	Xinghua
Tofovic	Stevan
Bahary	Nathan
Perry	Lina
Carcillo Jr	Joseph
Mattila	Polly
Palevsky	Paul
Kocyildirim	Ergin
Ramaeker	Devon
Kupfer	David
Bartlett	David
Fidan	Emin
Vergis	Emanuel
Schoen	Robert
Schirda	Claudiu
Averch	Timothy
Ross	Sarah
Gosman	Gabriella
Pascal	Laura
Kim	Kyu Pyo
Straub	Adam
Buland	Justin
Clump	David
Simerly	Calvin
Catov	Janet
Roberts	James
Chen	Beatrice
Hu	Jie
Faeder	James
Vries	John
Andolina	Laurie
Lin	Charles
Maxwell	Matthew
Celedon	Juan
Cornelius	Marie
Fertig	Alexis
Silverman	Gary
Peitzman	Andrew
Sukumvanich	Paniti
Jabbour	Noel
Roppolo	James
Ryan	Neal
Rabinovitz	Hanna
Challinor	Sue
Berger	Rachel
ODonnell	Christopher
Scott	Melanie
Vo	Nam
Badrane	Hassan
Cornelius	Jack
Kim-Campbell	Nahmah
Yang	Charles
Lee	Robert
Chu	Andrew
Noda	Kentaro
Perkins	Kenneth
Benoit	Ronald
Boyiadzis	Michael
Kellum	John
Aujla	Shean
Goyal	Rakesh
Granieri	Rosanne
Whyte	Ellen
Lesniak	Bryson
Bosch	Patrick
Morris	Sidney
Humphrey	Allen
Potoka	Douglas
Ge	Yinghui
Mammen	Oommen
English	Joseph
Finder	Jonathan
Gillman	Grant
Mendelson	Stephen
Kashlan	Ossama
Fyffe-Maricich	Sharyl
Nicholls	Robert
Tashman	Scott
Kegel	Nathan
Douaihy	Antoine
Spiess	Alexander
Gao	Wentao
Boninger	Michael
Mccaffrey	Francis
Goldstein	Amy
Baty	Catherine
Sumpter	Tina
Mohan	Deepika
Vyas	Dharmesh
Robinson	Keven
Meirovitch	Hagai
Minshew	Nancy
Kentor	Michael
Wechsler	Lawrence
Lagasse	Eric
Wukich	Dane
Inglesby	Thomas
Sanfilippo	Joseph
Ahmed	Hesham
Bangalore	Srihari
Schelbert	Erik
Shrivastava	Indira
Haas	Gretchen
Johnson	Bruce
Booth	Jaime
Schindler	John
Kelley	Eric
Nichols	A
Tan	Henkie
Gach	H
Riley	Melissa
Popescu	Iulia-Dana
Chung	Tammy
Oluoch	Julia
Dauber	James
Amidi	Morteza
Smith	Anson
Diler	Rasim
Paranjpe	Shirish
Khan	Saleem
Bovbjerg	Dana
Kostka	Dennis
Facco	Francesca
Grandi	Paola
Wells	Cynthia
Kim	Tae
Gimbel	Michael
Courcoulas	Anita
Lindell	Kathleen
Gorantla	Vijay
Johnson	Ronald
Sehgal	Alison
Wilkins	Isabelle
Aizenstein	Howard
Lombardi	Benito
Jazwinski	Alison
Avgerinos	Efthymios
Qian	Wei
Yip	Linwah
Hochheiser	Harry
Kensler	Thomas
Gonzalez Burgos	Guillermo
Salata	Roseann
Pennathur	Arjun
Updike	Glenn
Sappington	Penny
Schell	Jane
McMakin	Dana
Furlan	Alessandro
Camacho	Carlos
Molina	Brooke
Orenstein	Susan
Bonidie	Michael
Fogle	Keri
DeLany	James
Resnick	Neil
Ocak	Iclal
Schwartz	Andrew
Brooks	Robert
Baril	Donald
Kwiatkowski	Adam
Tudorascu	Dana
Wakabayashi	Nobunao
Ward	W
Tersak	Jean
Pogacnik	Javier
Lan	Li
Mulvey	Edward
Domsic	Robyn
Bahar	Ivet
Travis	Michael
Hong	Chang Sook
Watson	Gregory
Sen	Malabika
Golla	Saraswathi
Foley	Thomas
Liu	Youhua
Liu	Zuqiang
Butterworth	Michael
Andreescu	Carmen
Gong	Zhenwei
Chu	Tianjiao
Sapra	Manish
Blasiole	Brian
Gellad	Walid
Shalom-Barak	Tali
Clark	Jerry
Benos	Panagiotis
Thompson	Robert
Oury	Tim
Gonzaga	Alda
Carney	Jonathan
Kwun	Hyun Jin
Turner	Neill
Bina	James
Yao	Jeffrey
Pantanowitz	Liron
Morone	Natalia
Gries	Cynthia
Esni	Farzad
Rogers	Kenneth
Ezzelarab	Mohamed
Myers	Eugene
Erdos	Geza
Widnell	Christopher
Young	Won-Bin
Dede	Ozgur
Rickin	Eric
Balzer	Jeffrey
Tarkin	Ivan
Bae	Kyong
Reed	Douglas
Csanyi	Gabor
Kulkarni	Sucheta
Smith	Amanda
Goyal	Shami
Bonaventura	Marguerite
Patton	Timothy
Zamora	Ruben
Forrest	Paige
Decker	Michael
Bell	Michael
Hellwig	Sabine
Cifuentes-Pagano	Maria
Tevar	Amit
McEnaney	Ryan
Himmelhoch	Jonathan
Cheng	Hongying
Whitcomb	David
Dhaliwal	Deepinder
Piraino	Beth
Radomski	Marek
Pagano	Patrick
Montoya	Mario
Pan	Jullie
Chartoumpekis	Dionysios
Gelzinis	Theresa
Branstetter	Barton
Barnes	Elvis
Egloff	Ann
Bhende	Mananda
Nalesnik	Michael
Lavasani	Mitra
Nguyen	Vu
Crowley	John
Jankowitz	Rachel
Viegas	Melita
Acarturk	Tahsin
Sit	Dorothy
Waters	Jonathan
Shalaby	Alaaeldin
Goins	William
Dzialowski	Kenneth
Bernstein	Cherly
Van Houten	Bennett
Wang	Qingde
Mishima	Takuya
Conner	Ian
Herman	Jim
Martin	Christopher
Venkataraman	Shekhar
Tai	Changfeng
Neches	William
Candrilli	Carolyn
Low	Carissa
Richardson	Robert
Zhang	Mei
Kang	Ja Hyun
Oberbarnscheidt	Martin
Schwartz	Marc
Heron	Dwight
Bagic	Anto
Skolnick	M
Wang	Guoliang
Schumann	John
Lambore	Sanjay
Pacella	Charissa
Swoger	Jason
Wang	Wei
Schopfer	Francisco
Volk	David
Chen	Xucai
Marroquin	Oscar
Abrams	Gordon
Pandey	Udai
Bodnar	Richard
Suski	Valerie
Conroy	Margaret
Shaikh	Obaid
Wallace	Meredith
Workman	Creg
Namas	Rami
Lei	Yu
Zhang	Lin
Villanueva	Flordeliza
Hathaway	Bridget
Wells	Alan
Brozanski	Beverly
Bergman	Ira
Niranjan	Ajay
Badylak	Stephen
Klena	James
Mathers	Alicia
Berg	Wendie
Wang	Dawn
Bondi	Corina
Badhwar	Vinay
Ferris	Laura
Triulzi	Darrell
Bogen	Debra
Duker	Georgia
McLane	Melissa
Pletcher	Jonathan
Grandinetti	Lisa
Gibson	Kevin
Kraemer	Kevin
Morelli	Adrian
Bond	Geoffrey
Kanter	Adam
Marcsisin	Michael
Inoue	Hideki
Chao	Cherng
Needleman	Herbert
Mcdonald	Robert
Cao	Guo
Barrington	William
Rubin	Joseph
Duensing	Anette
Hendricks	Robert
Crumrine	Patricia
Melhem	Mona
Harrison	Lee
Wagner	Michael
Siminerio	Linda
Dombrovski	Alexandre
Puhalla	Shannon
Hornyak	Victoria
Massart	Mylynda
Banihashemi	Layla
Conklin	Cynthia
Hamel	Sara
Ranganathan	Sarangarajan
Lee	Janet
Puyana	Juan
Zuccoli	Giulio
Han	Lihong
McAninch	Brett
Hess	Rachel
Choi	Sylvia
Craig	Fiona
Singh	Manjit
Hasley	Stephen
Liang	Kelly
Kano	Hideyuki
Pociask	Derek
Koes	David
Bisello	Alessandro
Tobon	Hector
Buranosky	Raquel
Kagemann	Lawrence
Fox	Ira
Frank	Ellen
Hillier	Sharon
Rondon Berrios	Helbert
Manders	Ernest
Tedrow	John
Pinter	Joshua
Sturdevant	Mark
Zhang	Qiuhong
Cabacungan	Leonard
Huppert	Theodore
Monaco	Edward
Yu	Francois
Morrow	Lisa
Parness	Jerome
Hoffee	Patricia
Peel	Robert
Koerber	H
Beasley	Harley
Zhang	Liyong
Lamarre	Neil
Germain	Anne
Chaves-Gnecco	Diego
Vujanovic	Lazar
Heyman	Rock
Lo	Cecilia
Grant	Kinzya
Chan	Chuen
Cameron	Judy
Lee	SoJung
Helkowski	Wendy
Cranston	Ross
Yates	Nathan
Soliman	Doreen
He	Kai
Gingo	Matthew
Shields	Ryan
Duncan	Andrew
Huq	Mohammed
Dela Torre	Luis
Beers	Sue
Thomas	Gary
Hammer	Maxim
Sekula	Raymond
Varon	Daniel
Mehta	Rajil
Schultz	Brian
Fish	Kenneth
Asato	Miya
Zhu	Jianhui
Paris	Paul
Horner	Michelle
D'Cunha	Jonathan
Miller	Mark
Price	Julie
Sun	Mingui
Weiner	Debra
Turturro	Michael
Sheng	Shaohu
Zhang	Cheng
Kang	James
Wilson	David
Luppi	Patrizia
Sundd	Prithu
Schlesinger	Abigail
Hoffman	Eric
Weisbord	Steven
Nowalk	Mary
Yousem	Samuel
Larkin	Allyson
Zeh	Herbert
Chalasani	Geetha
De Toledo	Frederico
Bai	Mingfeng
Hager	Eric
Sperling	Mark
Thorne	Stephen
Stahl	Sarah
Speer	Paul
Buffer	Sam
Pilkonis	Paul
Strollo	Diane
Cole	Kelly
Kandler	Karl
Schwartzman	David
Guo	Ping
Gimbel	Alison
Klatt	Brian
Palmer	Octavia
Prasad	Konasale
Holtzman	Matthew
Landau	Michael
Kumar	Ajay
Ondecko Ligda	Kristin
Phillips	Bruce
Kmiec	Julie
Crock	Fred
Doi	Yohei
Taylor	Douglass
De Castro	Laura
Amin	Rajnikant
Causer	Victoria
Kamath	Ravindra
Gomez Amaya	Sandra
Boardman	John
White	Crystal
Nash	Kenneth
Ghazi	Arjuman
Oriss	Timothy
Chou	Hsiang-Yi
Muzumdar	Radhika
Wang	Ling
Tuan	Rocky
Nimgaonkar	Vishwajit
Suffoletto	Brian
Aizenman	Elias
Kuhn	Bernhard
Diven	Warren
Engh	Johnathan
Wu	Xubo
Miller	Kimberly
Pettegrew	Jay
Kanal	Emanuel
Garrison	Jessica
Fan	Ming-Hui
Achilles	Sharon
Fajt	Merritt
Rozel	John
Thurston	Rebecca
Orwig	Kyle
Li	Hui
McElwain	Mari Ann
Bullock	Grant
Yip	Joseph
Reyes Mugica	Miguel
Zhao	Jing
Sweet	Robert
Lin Tsung	Eva
Fecek	Ronald
Venkat	Veena
Levy	Ryan
Halder	Indrani
Radovic-Stakic	Ana
Huang	Hai
Frizzell	Raymond
Castle	Nicholas
Narendran	Rajesh
Rodosky	Mara
Vuga	Louis
Woods	Shailen
Leyva	William
Radomski	Michal
Johnston	James
Lowe	Mark
Austin	Robert
Shah	Nirav
Singh	Nina
Orr	Richard
Fuchs	Franklin
Gittes	Elissa
D'Cruz	Louise
Orebaugh	Steven
Schatten	Gerald
Vats	Kalyani
Armstrong	Michaele
Mollen	Kevin
Tamber	Mandeep
Brown	Charlotte
Ohori	N
Papachristou	Marios
Yu	Jing
Liang	Xiaoyan
Gao	Yanhua
Schuman	Joel
Wearden	Peter
Deng	Meihong
Phrampus	Paul
Chang	Yuan
Elnicki	David
Sullivan	Daniel
Sitwat	Bilal
Handen	Benjamin
Barnato	Amber
Clarkson	Becky
Jain	Sandeep
Bertrand	Carol
Bender	Charles
Mouillet	Jean Francois
Gaunt	Robert
Alvarado	John
Swartz	Holly
Nace	David
Falo	Louis
Arjunan	Palaniappa
Dong	Hengjiang
Mehta	Deepak
Lancaster Jr	Jack
Shlomchik	Mark
Imber	Stanley
Cohen	Jeffrey
Burns	Timothy
Papachristou	Georgios
Strollo	Patrick
Mazariegos	George
Cacciarelly	Thomas
Chough	Denise
Blair	Harry
Reddy	Vivek
Yadav	Dhiraj
Forte	Patrick
Riddler	Sharon
Scanga	Charles
Macpherson	Trevor
Sun	Bin
Katyal	Sikandar
Fu	Lai
Eisses	John
Ryman	Katherine
Dimartini	Andrea
Byers	Karin
Thomson	Angus
O'Keefe	Elizabeth
Wollman	Michael
Jovin	Tudor
Littleton	Eliza
Duvvuri	Umamaheswar
Williams	John
Horton	John
Follansbee	William
Bernardo	Jose
Dougherty	George
Kreit	John
Lucas	Peter
Flickinger	John
Prasadan	Krishna
Soundara Rajan	Deepa
Roth	Christine
Cambi	Franca
Kaniecki	Robert
Bencherif	Badreddine
Hagen	Tanya
Cooper	Gregory
Wu	Christine
Ragni	Margaret
Althouse	Andrew
Katz	Jeremy
Greene	Stephanie
Van Kammen	Daniel
Ortiz Aguayo	Roberto
Toma	Catalin
Defrances	Marie
Hotchkiss	John
Donovan	Maryann
Manole	Mioara
Clancy	Cornelius
Landsittel	Douglas
Chu	Danny
Bradberry	Charles
Srinath	Arvind
Schenker	Yael
Reis	Evelyn
McGowan	Ian
Belfer	Inna
Parikh	Urvi
Suresh	Srinivasan
Shigemura	Norlhisa
Ganguli	Mary
Raz	Yael
Alarcon	Louis
Wang	Zhi Qiang
Prochownik	Edward
Bircher	Nicholas
Parwani	Anil
Drash	Allan
Katz	Aviva
Vilardaga	Jean
Escobar	Fernando
Oertel	Michael
Sheth	Heena
Davis	Brian
Kelley	Joseph
Watkins	Simon
Kinnane	Janet
Thibodeau	Patrick
Cook	Chris
Liu	Qing
Solai	Lalithkumar
Dandachi	Nadine
Greenamyre	John
Ramaswami	Balathiripura
Clermont	Gilles
Gordon	Adam
Menke	Marie
Good	Chester
Davis	Peter
Bilonick	Richard
King	Linda
Milcarek	Christine
Nicolescu	Anton
Ducruet	Andrew
Spiker	Duane
Glorioso	Joseph
Laymon	Charles
Anish	Eric
Cladis	Franklyn
Wang	Bing
Drickman	Johanna
Deeney	Vincent
Dezfulian	Cameron
Krohner	Robert
Forsythe	Raquel
Borle	Andre
Escolar	Maria
Choi	Sukgi
Visoiu	Mihaela
Karp	Jordan
Furtado	Andre
De La Cruz	Carolyn
Winter	Peter
Zahid	Maliha
Brackney	Christopher
Demetris	Anthony
Gladwin	Mark
Puttarajappa	Chethan
Mansour	Hader
Houtrow	Amy
Roberts	Michelle
Cooper	James
Zickmund	Susan
Abdel Kawy Abdalla	Wael
Kowalski	Regis
Youngner	Julius
Sherman	Frederick
Rabinovitz	Mordechai
Aiyer	Aryan
Sivak	Erica
Melhem	Nadine
Simons	Daniel
Gulati	Vijay
Billiar	Timothy
Schmidt	Martin
McCarran	William
Henry	Luke
Donadee	Chenell
Subramaniam	Kathirvel
Sogawa	Hiroshi
Aggarwal	Rohit
Galang	Gary
Pettigrew	Chenits
Lamb	Jason
Callahan	Patrick
Maier	Robin
Becker	James
Safier	Robert
Virji	Mohamed
Hariharan	Jaishree
Smith	Kenneth
Grau	Thomas
Xiong	Zeyu
Burns	Patrick
Ho	Ken
White	Douglas
Hetherington	Hoby
Six	Cheryl
Veeragandham-Anne	Gautami
Salcido	David
Ramanathan	Ramesh
Patterson	Kevin
Panigrahy	Ashok
Hill	Shirley
Orenstein	David
Coyne	Bonnie
Yealy	Donald
Schott	Christopher
Sorkin	Alexander
Khalid	Asif
Rotondi	Armando
Brandom	Barbara
Sun	Quanhong
Willenkin	Robert
Furman	Joseph
Elishaev	Esther
Chen	Kong
Gandotra	Gaurav
Styn	Mindi
Motoyama	Etsuro
Conti	Kavitha
Brehm	John
Rosenkranz	Margalit
Chalifoux	Thomas
Carattino	Marcelo
McVerry	Bryan
Liu	Xiangrong
Bates	Carlton
Gildengers	Ariel
Gordon	Jerold
Rojas	Mauricio
Noll	Robert
Patel	Rita
Panko	Laura
Nathaniel	Vernon
Chew	Douglas
Guzman Lepe	Jorge
Vats	Abhay
Rittenberger	Jon
Torok	Kathryn
Biller	Aimee
Koharudin	Mohamad
Liu	Betty
Sperry	Jason
Azzuqa	Abeer
Oesterreich	Steffi
Ferris	Robert
Kalinski	Pawel
Abesamis	Michael
Chengappa	Kadiamada
Bron	Klaus
Moses-Kolko	Eydie
Gerlach	Jorg
De Vallejo	Abbe
Eichman	Adelaide
Blair	Kimberly
Aridor	Meir
Stetler	Ruth
Peters	Kathryn
Shen	Hongmei
Feingold	David
Collins	Michael
Shaw	Peter
Stepanczuk	Beth
Oudega	Martin
Yatsenko	Svetlana
Kaminski	Robert
Clark	Robert
Mcmahon	Deborah
Towers	Adele
Ewing	Linda
Loughran	Patricia
Turnquist	Heth
McAllister	Linda
Vernetti	Lawrence
Kuan	Shihfan
Smith	Roy
Mccloskey	Carol
Huen	Arthur
Rubio	Maria
Wollstein	Chaim-Gadi
Defranco	Donald
Chang	Yuefang
Hara	Hidetaka
Tyler-Kabara	Elizabeth
Thirumala	Parthasarathy
Vignali	Dario
Kaynar	Ata
Becich	Michael
Dum	Richard
Traub	Linton
Simons	Jeffrey
Mcneil	Melissa
Graham	Steven
Teuteberg	Jeffrey
Holzinger	Elmer
Galson	Deborah
Viswanathan	Pushpa
Jonassaint	Charles
Galbiati	Daniela
Goldstein	Tina
Jonassaint	Naudia
Hudson	Mark
Bump	Gregory
Moossy	John
Levitan	Edwin
Salter	Russell
Hoyos	Catalina
Tillman	Bryan
Pipeling	Matthew
Galbiati	Ferruccio
Yates-Binder	Cecelia
Ray	Kristin
Zureikat	Amer
Mohsen	Al-Walid
Pizon	Anthony
Lee	James
Iouchmanov	Victor
Cook	Stacey
Kokai	Lauren
Ackerman	Kurt
Harner	Christopher
Alper	Cuneyt
Hamad	Giselle
Gunn	Scott
Austin	Kelly
Zhang	Xianghong
Brufsky	Adam
Sanchez de Toledo	Joan
Sarkaria	Inderpal
Greco	Carol
Patterson	Paul
Rothfus	William
Bontempo	Franklin
Weiss	Kurt
Jane	Esther
Murray	Holt
Collinger	Jennifer
Calero Velazquez	Guillermo
Hasler	Brant
Lotrich	Francis
Mockus	Linas
Thull	Darcy
Primack	Brian
Kelley	Donald
Zeleznik	Anthony
Ramaswamy	Suresh
Chiosea	Simion
Li	Hua
Egan	Charlotte
Huang	Yi
Urish	Kenneth
Tabas	Gary
D'Agostino	Louis
Escobar	Oscar
Ikonomovic	Milos
Premkumar	Daniel
Hughan	Kara
Hickey	Robert
Schaitkin	Barry
Douglas	Gerald
Dohar	Joseph
Lunz	John
Parks	William
Baumann	Barbara
Sah	Mukesh
Borrero	Sonya
Kodali	Ravindra
Zeevi	Adriana
Sando	Isamu
Wang	Norman
Tew	James
Pacella	John
Donnellan	Nicole
Sakai	Tetsuro
Felmet	Kathryn
Hamilton	Ronald
Greenspan	Susan
Cheng	Shao
Binion	David
Hallquist	Michael
Suenaga	Jun
McGeachy	Mandy
Yan	Hong
Gopalakrishnan	Vanathi
Pak	Stephen
Goitz	Robert
Brosenitsch	Teresa
Alcorn	John
Gillespie	Amanda
McCormick	Andrew
Watson	Katherine
Floros	Theofanis
Lee	Yong
Lindblad	Douglas
Bayir	Hulya
Hartmaier	Ryan
Carty	Sally
Lieberman	Rhett
Shiota	Chiyo
Kang	Rui
Yang	Yong
Birder	Lori
Forman	Steven
Steel	Jennifer
Mcintyre-Seltman	Kathleen
Fernandez-Miranda	Juan
Kontos	Anthony
Munoz	Ricardo
Tavarez	Melissa
Munin	Michael
Monaco	Sara
Gaffen	Sarah
Wang	Yao
Bakkenist	Christopher
Glick	Ronald
Stang	Michael
Fuhrman	Carl
Vaughan	Kevin
Brown	Amanda
Zhou	Xiuxia
Madan	Shobhit
Du	Yiqin
Nadkarni	Neelesh
Catullo	Victor
Ahrendt	Gretchen
Bissonette	David
Gomez Danies	Hernando
Bernstein	Kara
Satish	Latha
Nicotra	Matthew
Homanics	Gregg
Sakolsky	Dara
Fontes	Paulo
Gerszten	Peter
Libman De Gordon	Ingrid
Zhang	Jianying
Bucklew	Lawrence
Edwards	Wilson
Jedrych	Jaroslaw
Grandis	Jennifer
Marcus	Marsha
Atwood	Charles
Stefanovic-Racic	Maja
Ngan	Ka-Kei
Arslanian	Silva
Mazefsky	Carla
Jin	Tao
Lopez	Roberto
Domnina	Yuliya
Cavalcante	Joao
Andrews	Carol
Kleyman	Thomas
Reynolds	Charles
Moncla	Bernard
Nejak-Bowen	Kari
Johnson	Daniel
Wetzel	Ronald
Liang	Rui
Chaillet	John
Butcher	Brad
Bauman	Julie
Steinman	Richard
Watt-Morse	Margaret
Tublin	Mitchell
Quigley	Joanna
Linkov	Faina
Bulgari	Dinara
Ho	Kevin
Tyagi	Shachi
Nakajima	Satoshi
Andrews	Glenn
Gushchin	Ghennady
Ost	Michael
Ibinson	James
Hallows	Kenneth
Saladino	Richard
Gartner Schmidt	Jacqueline
Tsang	Michael Wai Kok
Wang	Zhou
Finegold	David
Higman	Henry
Perez	Monica
Schaffner	Erin
Soto Gutierrez	Alejandro
Callaway	Clifton
Kahn	Jeremy
Levina	Vera
Alissa	Feras
Sandrian	Michelle
Cohen	Cathy
Novelli	Enrico
Ventrelli	Stephen
Zeng	Dexing
Sogawa	Yoshimi
Mason	Gary
Perel	James
Luna	Beatriz
Joyce	Judith
Givelber	Rachel
Klain	Miroslav
Squires	Janet
Friberg	Thomas
Danby	Claire
Dobbelstein	Christopher
Stakic	Josif
Tang	Pei
Kovacs	Maria
Tarpey	Margaret
Singh	Jaspaal
Greenberger	Joel
Tsung	Allan
Urban	Amy
Sun	Weijing
Locker	Joseph
Xing	Juan
Gebhart	Gerald
Franzen	Peter
Roach	James
Rollman	Bruce
Obermajer	Natasa
Picard	Nathalie
Kulich	Scott
Jenkins	Frank
Schuh	Russell
Adelstein	Evan
Gardner	Kathy
Voigt	Andrew
Antony	Arun
Davies	Benjamin
Kim	Su-Yeon
Nine	Jeffrey
Cleveland	Christine
Mathis	Chester
Soloff	Paul
Snyder	James
Deible	Christopher
Derubertis	Frederick
Abdel Massih	Rima
Yoshimura	Naoki
Kolko	David
Popescu	Alexandra
Shanks	Robert
Sobehart	Robert
Isse	Kumiko
Crammond	Donald
Chennubhotla	Srinivas
Hartman	Douglas
Homayoun	Houman
Hall-Burton	Denise
Branch	Robert
Schulberg	Herbert
Gruen	Gary
Totoraitis	Ruta
Zuckerbraun	Brian
Lee	Byeong
Pasculle	A
Wu	Chuanyue
Friend	Christopher
Volkar	Judith
Young	VyVy
Nguyen	Khoa
Xu	Yan
Noaiseh	Ghaith
Shapiro	Richard
Simon	Marc
Zitelli	Basil
Dekker	Andrew
Ma	Dongzhu
DeLuca	Kerry
Amankulor	Ndukaku
Hasley	Peggy
Wu	Shandong
Evans	Andrew
Dicianno	Brad
Fernstrom	John
Hudak	Robert
Amesur	Nikhil
Dalby	Patricia
Bunge	Katherine
Contis	Lydia
Turner	Robert
Mendenhall	George
Poropatich	Ronald
Wiley	Clayton
Risbano	Michael
Camirand	Geoffrey
Chase	Henry
Davis	Denise
Abrams	Ya'Aqov
Dezzutti	Charlene
Boggs	Sallie
Behari	Jaideep
Teichert	Tobias
Romeo	Ryan
Levinthal	David
Ghuman	Avniel
Farr	Russell
Lee	Adrian
Mcivor	William
Brown	Aaron
Blackrick	Lisa
Morowitz	Michael
Johnson	Jonas
Kanai	Anthony
Richardson	Gale
Shepherd	Jonathan
Reis	Steven
Montelaro	Ronald
Pinkofsky	Harold
Thakrar	Darshit
Moalli	Pamela
Cabral	Carol
Babbar	Jatinder
Kershaw	Erin
Modo	Michel
Ono	Yoshihiro
Roy	Somak
Howland	Robert
Will	Jenny
Myaskovsky	Larissa
Ramanathan	Sivam
Goodman	Mark
Switzer	Galen
Diego	Emilia Josefa
Tadros	Sameh
Sukumvanich	Heather
Ahmari	Susanne
Chaer	Rabih
Miller	Elizabeth
Sharma	Mahesh
Forbes	Erika
Doyle	John
Oltvai	Zoltan
Basri	Osama
Flint	Amanda
Herschell	Amy
Ahn	Jinwoo
Moore	Patrick
Scolieri	Sun Kim
Chikina	Maria
Pastor Soler	Nuria
Huang	Yanhua
Medich	David
Ling	Wen
Harinstein	Matthew
Buysse	Daniel
Haarer	Kelly
O'Doherty	Robert
Mayle	Wendy
Waxman	Evan
Appleman	Leonard
Basford	Robert
Machiraju	Venkat
Ismail	Nahed
Birmaher	Boris
Rowe	Marc
Fried	Linda
Powers	Robert
Mora	Ana
Bell	Kevin
Jones	Miroslawa
Madan	Suneeta
Chi	David
Svobodova	Vera
Davison	Jon
Taylor	Jennifer
Heist	Brian
Walker	Aisha
Shu	Sherry
Nowalk	Andrew
Hsieh	Margaret
Wright	Rollin
Chakraborty	Dev
Bazaz	Raveen
Sharma	Anupama
Doyle	William
Boucek	Charles
Hukriede	Neil
Metes	Diana
Clemens	Paula
Butterfield	Lisa
Katz	William
Wilson	Stephen
Shi	Shujie
Degroat	William
Stepp	Stephanie
Petrov	Andrej
Both	Camila
Shinozuka	Hisashi
Jia	Wenyan
Zimmerman	Richard
Xu	Jing
Ganapathiraju	Madhavi
Hariharan	Sundaram
Berlin	Charles
Kitsko	Dennis
Bell	Aaron
Silveira	Fernanda
Kanbour-Shakir	Amal
Chelly	Jacques
Lamberty	Phillip
Ye	Sang Ho
Geller	David
Soose	Ryan
Pai	Reetesh
Conti	Tracey
Goldstein	Jesse
Chandra	Divay
Duerr	Richard
Moritz	Michael
Martin	Judith
Guyette	Francis
Rakfal	Susan
Pollack	Ian
Abo	Steven
Vazquez	Alberto
Li	Feng
Hughes	Christopher
Rustgi	Vinod
Epperly	Michael
Segel	David
Yeh	Joanne
Rubio	Doris
Crippen	David
Baldwin	Maria
Yanowitz	Judith
Lance-Jones	Cynthia
Cook	Stephen
Wiesenfeld	Harold
Chang	Jason
Bise	Christopher
Tsui	Fu
Fu	Freddie
Yu	Victor
Steed	David
Mars	Wendy
Sicari	Brian
Chen	Jun
Hill	Lyndon
Torres	Gonzalo
Scholz	Stefan
Gilbert	James
Brancolini	Scott
Jiang	Xia
Saller	Devereux
Klionsky	Bernard
Schraut	Wolfgang
Crespo	Maria
Zarour	Hassane
Humar	Abhinav
Visweswaran	Shyam
Mason	Neal
Tulsky	Asher
Lee	Jenifer
Kolls	Jay
Yates	Adam
Sciurba	Frank
Conway	James
Medsger	Thomas
Goyal	Alka
Fine	Michael
Soltys	Kyle
Hanlon	Joseph
Berlacher	Kathryn
Weisel	Florian
Drappatz	Jan
Rajkovic	Aleksandar
Guido	Richard
DeBrunner	Mark
Rana	Sangeeta
Vellody	Kishore
Menegazzi	James
Vodovotz	Yoram
Kim	Kang
Mares	Aaron
McDyer	John
Morrell	Matthew
Tzeng	Edith
Baidoo	Leonard
Luketich	James
Jaffe	Thomas
Djokic	Miroslav
Pugliano Mauro	Melissa
Lacomis	Joan
Yatsenko	Alexander
Shestak	Kenneth
Telesco	Richard
Walker	Garth
Stowell	Keith
Seo	Gloria
Monga	Satdarshan
Roth	Ronald
Clavell	Maria
Schoedel	Karen
Piganelli	Jon
Keskinov	Anton
Semins	Michelle
Liang	Kimberly
Schneck	Francis
Docimo	Steven
Puccio	Ava
Michalopoulos	George
Ritchey	A
Eagon	Patricia
Malinow	Ana
Liu	Yang
Adams	Richard
Perlman	Susan
Kumar	Pawan
Jaffe	Ronald
Romero	Guillermo
Jackson	Travis
Daly	Ivonne
Ma	Jihong
Gorcsan	John
Torregrossa	Mary
Tzounopoulos	Athanassios
Isenberg	Jeffrey
Kochanek	Patrick
Zivkovic	Sasa
Allada	Vivekanand
Holder-Murray	Jennifer
Castro Diaz	Sergio Mario De Jesu
Nakagomi	Hiroshi
Trivedi	Dhaval
Mathier	Michael
Mulukutla	Suresh
Kunz	Heinz
Leader	Joseph
Corcoran	Timothy
Nickerson	Kevin
Chong	Hey
Vasile Pandrea	Ivona
Al-Khoury	Georges
Lakoski	Joan
Whitehurst	Steven
Pike	Francis
Hirsch	Barry
Kullmann	Florenta
Ikeda	Youko
Ohearn	Kirsten
Reddy	P
Counihan	Peter
Bakalov	Veli
Lee	Robin
Navolotskaia	Olga
Schmidhofer	Mark
Halvas	Elias
Rodriguez	Eric
Shi	Haibin
Ellis	Demetrius
Gregory	Alyssa
Irrgang	James
Wu	Yijen
Suyama	Joe
Van Deusen	Reed
Muthukrishnan	Ashok
Yende	Sachin
Mahmood	Burhanuddin
Gopalan	Priya
Ambrosio	Fabrisia
Dorfsman	Michele
Vaisleib	Inna
Miller	Benjamin
Reinmuth	Oscar
Dube	John
Du	Qiang
Shurin	Galina
Yates	Adolph
Kanias	Tamir
Darby	Joseph
Moore	Robert
Wang	Hongkun
Yang	Min
Polderman	Kees
Liu	Hao
Lattanzi	Daniel
Twichell	Maria
Chen	Fenghua
Moossy	John
Kullmann	Paul
Dunn	Michael
Sarkar	Saumendra
Wendell	Stacy
Katari	Sunita
Han	Jie
Zhang	Yingze
Sutkin	Gary
Hamilton	Melinda
Gronvall	Gigi
Shah	Amisha
Bluestone	Charles
Delfyett	William
Nguyen	Nghi
Wallace	David
Rao	Kanchan
Cohen	Ann
Tadic	Stasa
Dabbs	David
Drain	Peter
Cremer	Miriam
Bachman	Peter
Lakkis	Fadi
Kapetanaki	Maria
Maldjian	Takouhie
Corzo Casadiego	Maria
Storkus	Walter
Makaroun	Michel
Kroboth	Frank
Snitz	Beth
Hakala	Thomas
Grunwaldt	Lorelei
Drabek	Tomas
Seal	Rebecca
Fleischer	Allison
Newsome	Joseph
Wu	Timothy
Cheng	Jing
Rubin	Fred
Gusenoff	Jeffrey
Bui	Diemthuy
Maul	Timothy
Allada	Stacey
Jacobson	Sansea
Wasan	Ajay
Lee	Grace
Gyulai	Ferenc
Im	Annie
Cooper	Gregory
Gittes	George
Ma	Changqing
Kuzmishin	Janet
Hughes	Marion
Kauma	Scott
Castro	Carlos
Wong	Timothy
Van Cott	Anne
Rajakumar	Kumaravel
Ford	Marijn
Mullin	Jeffrey
Nayak	Shweta
Biswas	Partha
Wisnowski	Jessica
Lathrop	Kira
Pitetti	Raymond
Fischer	Gary
Sheng	Yi
Good	Misty
Bekhuis	Tanja
Tejero Bravo	Jesus
Miyagawa	Yoshitaka
Modugno	Francesmary
Ling	Bruce
Hoffman	Donna
Rofey	Dana
Mccluskey	Kevin
Wang	Dan
Meyer	Mark
Zheng	Michael
Hidvegi	Tunde
Teixeira	Miriam
Feingold	Brian
Felgar	Raymond
Zhou	Yiqin
Cortazzo	Megan
McAuliffe	Priscilla
Lagenaur	Carl
Wang	Yudong
Xiao	Bo
Lee	John
Roy	Ankita
Ho	Jonhan
Wyse	Aaron
Fisher	Lee
Lim	Katherine
Emery	Stephen
Kirimli	I
Metro	David
Kaltenmeier	Christof
Donaldson	William
Christie	Neil
Bissel	Stephanie
Qu	Zhaoxia
Cassidy	Elaine
Lazo	John
Kormos	Robert
Scott	Lori
Grudziak	Jan
Perlmutter	David
Jeyabalan	Arundhathi
Nagarajan	Shanmugam
Giraldo Duque	Melissa
Luo	Jianhua
Pinsky	Michael
Jiang	Yu
Murdoch	Geoffrey
Price	Rebecca
Tawbi	Hussein
Lopez	Oscar
Starzl	Thomas
Alper	Gulay
Bowen	A'Delbert
Sowa	Gwendolyn
Finn	Frances
Swamynathan	Shivalingappa
Nelson	Joel
Washington	Kia
Sullivan	Erin
Lee	Ashley
Hong	Yang
Fourcade	Julien
Wan	Yong
Sigal	Ian
Jackman	Stephen
Wagner	William
Malek	Marcus
Glausier	Jill
Becker	Dorothy
Cooper	David
Dunmire	Susan
Leers	Steven
Maricich	Stephen
Sakamoto	Sara
Miyashita	Yosuke
Mamonova	Tatyana
Gur	David
Salisbury	Dean
Rubin	Joshua
Rinaldo	Charles
Walker	William
Hardesty	Robert
Yanowitz	Toby
Hakim	Christiane
Troen	Philip
Bhatnagar	Sonika
Lovig	Leif
Lucas	Sunder
Yang	Lei
Davis	Amy
Glance	Jody
Mcnamara	Dennis
Yu	Lan
Copley-Woods	Noedahn
Park	Seo Young
Malec	Lynn
Ishikawa	Hiroshi
Chu	Edward
Thompson	Ann
Kameneva	Marina
Puskar	Alicia
Gibson	Sarah
Lee	Dae Hee
Hogg	Melissa
Morel	Penelope
You	Zhaoyang
Campfield	Brian
Palekar	Alka
Wright	Vonda
Saba	Samir
Nguyen	Christina
Crist	Lawrence
DiCicco	Leigh
Reddy	Raju
Rudolph	Jeffrey
Singh	Shivendra
Bina	Xiaowen
Cannon	Glenn
Chauhan	Bharesh
Wang	Huicong
Cummings	Dana
Jain	Abhishek
Mangione	Michael
Yates	Billy
Shende	Manisha
Donovan	Anna
Ismail	Hebatullah
Zhou	Jingjiao
Maranchie	Jodi
Vander Lugt	Mark
Ray	Prabir
He	Mingjing
Scruggs	Katherine
Lance	Audrey
Carson	Andy
Li	Jihong
Khan	Shabana
Borhani	Amir
Nason	Katie
Saenz Gaitan	Lucas
Sareyyupoglu	Basar
Marshal	Michael
Nikiforova	Marina
Kline	Anthony
Sachdev	Ulka
Henderson	Donald
Woodcock	Steven
Morell	Victor
Jadhav	Ashutosh
Starr	Matthew
Jennings	Constance
Thomas	Holly
Balsan	Michael
Huang	Guofeng
Beckjord	Ellen
Lowery	Amy
Eibling	David
Almusa	Omar
Shaikh	Nader
Mcclane	Bruce
Tan	Roderick
Horvath	Zsuzsa
Dorritie	Kathleen
Brand	Rhonda
Lima	Claudio
Wang	Haibin
Navid	Forozan
Baltasar Tello	Itziar
Davis	Esa
Stern	Andrew
Moon	Chan-Hong
Roth	Kimberly
Zhang	Peijun
Gonzalez	Stephanie
Frederick	Sean
Kristo	David
Hofkosh	Dena
Chelluri	Lakshmipathi
Yu	Jian
Al-Khafaji	Ali
Deluca	Neal
Cohlan	Barbara
Eiseman	Julie
Rao	Gutti
Arora	Gaurav
Adibi	Siamak
Dillavou	Ellen
Friehling	Erika
Gutkin	Dmitriy
Johnson	Eric
Lamitina	Samuel
Childers	Julie
Neumann	Carola
Rosso	Andrea
Lillien	Laura
Marin	Jennifer
Ploof	Dianna
Clark	Melissa
Craigo Steckbeck	Jodi
Zhang	Yu
Fitz	Charles
Shuda	Masahiro
Oddis	Chester
